
* * * * * * * * * * * 
*       *       *   * 
*   *   *   *   *   * 
*   *   * S *   *   * 
*   *   * * *   *   * 
*   *   *       *   * 
*   * * *   * * *   * 
*       *           * 
*   *   * * * * *   * 
* E *               * 
* * * * * * * * * * * 